1111111111111111
1000000000000001
1011111111111101
1010000000000001
1010111111101101
1000000000001101
1010110001101101
1010111111101101
1010000000000101
1011111111111101
1000000000000001
1111111111111111