111111111111111111111111111111111111
100000000000000000000000000000000001
101110111011101111011101110111010001
101110111011101111011101110111010001
101110111011101111011101110111010001
100000000000000000000000000000000001
101111011101110111011101110111011101
101111011101110111011101110111011101
101111011101110111011101110111011101
100000000000000000000000000000000001
101110111011101110111011101110111001
101110111011101110111011101110111001
101110111011101110111011101110111001
100000000000000000000000000000000001
101111011101110111011101110111011101
101111011101110111011101110111011101
101111011101110111011101110111011101
100000000000000000000000000000000001
101110111011101110111011101110111001
101110111011101110111011101110111001
101110111011101110111011101110111001
100000000000000000000000000000000001
101111011101110111011101110111011101
101111011101110111011101110111011101
101111011101110111011101110111011101
100000000000000000000000000000000001
101110111011101111011101110111010001
101110111011101111011101110111010001
101110111011101111011101110111010001
100000000000000000000000000000000001
111111111111111111111111111111111111