1111111111111111111111111111
1000000000000000000000000001
1011110111110111110111110101
1011110111110111110111110101
1011110111110111110111110101
1000000000000000000000000001
1011110222011111022201110101
1011110212011111021201110101
1011110222011111022201110101
1000000000000000000000000001
1111111111110111101111111111
0000000000000111100000000000
1111111111110111101111111111
1000000000000000000000000001
1011110111110111110111110101
1011110111110111110111110101
1011110111110111110111110101
1000000000000000000000000001
1011110222011111022201110101
1011110212011111021201110101
1011110222011111022201110101
1000000000000000000000000001
1011110111110111110111110101
1011110111110111110111110101
1011110111110111110111110101
1000000000000000000000000001
1111111111111111111111111111