1111111111111111
1000000000000001
1011111111111101
1010000000000101
1010111101110101
1010000000100101
1010111101110101
1010000000000101
1011111111111101
1000000000000001
1111111111111111